# #  #  ### # #  #  ### ###  #  ### 
### # # # # # # # #  #   #  # # # # 
### ### # # ### ###  #   #  ### # # 
# # # # # # # # # #  #   #  # # # # 
# # # # # # # # # #  #   #  # # # # 